R 500 500

NO ../textures/eagle.xpm
SO ../textures/bluestone.xpm
WE ../textures/bluestone.xpm
EA ../textures/wall_4.xpm

S ../textures/pillar.xpm
F 163,104,64
C 205,249,255

11111111111111111111111111111
10000000001100000000000000001
10111000011100000010020010001
10100002000000200000000100001
101100000111000N0000000010001
10000000001100001112011110001
11110111111111011100000010001
11110111111111011101010000001
11000000110101011000000000001
10000000020000000000000000001
10000000000000001101012010001
11000000110101011111011110001
11110111111101011111011110001
11111111111111111111111111111
